00010000000000000000!
00010000000000011111!
00011110000000010000!
00000010000000110000!
00000010000000100000!
00111110000000100000!
00100000000000100000!
00100000000111100000!
00111111111100000000!
00000000000000000000!
00000000000000000000!